10
oXXXXXXXXX
X   X    X
X XXXXX XXX
X X     X X
X X XXX X X
X X X X X X
X X X X X X
X X X X   XX
X   XXXXXX
XXXXXXXXXp