10
XXXXXXXXXX
Xo    X  X
X XXXXX XXX
X X X   X X
X X XXX X X
X X X X X X
X X X X X X
X X X X   XX
X   XXXXXX
XX  XXpXX 