5
XXXXXX
Xo  XX
X XX X
XX XXX
X p XX
XXXXXX