10
XXXXXXXXXX
X   XXXXXX
X X XXXX X
X X XX  XX
X XX XX XX
X  X o XXX
XX X  X  X
XXX XX XXX
XX  XX   X
XXpXXXXXXX