      XoX      
     XXXXXXXXXX
     XXXXXXXXXX
             XX
             XX
    XXXXXXXXXX 
XXXXXXXXX      
XX             
XXXXXXXXXX     
XXXXXXXXXX     
      XpX      